TST = "countries/Test.txt"
ASH = "countries/Ashbury.txt"
VAR = "countries/Varania.txt"
EFS = "countries/Eisenfront.txt"
ELU = "countries/East Lusatia.txt"
WLU = "countries/West Lusatia.txt"
NCT = "countries/Nerrocita.txt"
LUT = "countries/Lutonea.txt"
SKT = "countries/Sakartvelo.txt"
SQP = "countries/Shqiperia.txt"
KIL = "countries/Holy Kingdom of the Isles.txt"
FSV = "countries/Fascist State of Varania.txt"
WMC = "countries/Welt's Mercenaries.txt"
RAG = "countries/Raggazia.txt"
ESB = "countries/Eichsburgh.txt"
SSD = "countries/Seaside.txt"
BLH = "countries/Blackhill.txt"
GLD = "countries/Goldenberry.txt"
MSF = "countries/Mistfield.txt"
RVL = "countries/Riverwell.txt"
VKS = "countries/Vicksondale.txt"
LMK = "countries/Lemko.txt"
WSC = "countries/Ward Street.txt"
TFT = "countries/Tuft√¶ll.txt"
SKR = "countries/Skyrona.txt"
PRI = "countries/Perinthia.txt"
ATF = "countries/Antifu.txt"
FDR = "countries/Nirfok.txt"
ODR = "countries/Oderic.txt"
ILV = "countries/Ilvan.txt"
AMA = "countries/Amaroa.txt"
JIX = "countries/Principality of Jixiang.txt"
DAI = "countries/Remnant of Daizhuang.txt"
HAT = "countries/Haitiang State.txt"
SAN = "countries/Principality of Sangchon.txt"
CHE = "countries/Tai Cheong.txt"
AMS = "countries/Amsar.txt"
QIN = "countries/Qingjiao.txt"
TPZ = "countries/Trapezos.txt"
LSN = "countries/Lusaine.txt"
KNK = "countries/Kanikleios.txt"
KTP = "countries/Katepano.txt"
XNH = "countries/Xinhuang State.txt"
MNM = "countries/Minamikawa.txt"
BND = "countries/Bandar.txt"
TAE = "countries/Taejongpa.txt"